00000000000000000000000000000000
00000000000000000000000000000000
00000000000000000000000000000000
00000000000000000000000000000000
00000000000000000000000000000000
00000000000000000000000000000000
00000000000000000000000000000000
00000000000000000000000000000000
00000000000000000000000000000000
00000000000000000000000000000000
00000000000000000000000m00090000
00000000000000000000111111110000
00000000000000000000000000000000
0000m000000000000000000000000000
00111111111111111000000000000000
00000000000000000000000000000000
00000000000000000000000000000000
00000000000000000111111111000000
00000000000000000000000000000000
00000000000000000000000000000000
0000000000000000000000000000m000
00000000000000m00001100000111100
00111111111111111000000000000000
00000000000000000000000000000000
00000000000000000000000000000000
00000000000000000000000000000000