00000000000000000000000000000000
00000000000000000000000000000000
00000000000000000000000000000000
00000000000000000000000000000000
00000000000000000000000000000000
00000000000000000000000000000000
00000000000000000000000000000000
00000000000000000000000000000000
00000000000000000000000000000000
00000000000000000000000000000000
00000000000000000000000000000000
00000000000000000000111111000000
00000000000000000000000000000000
00000000000000000000000000000000
00111111111111111000000000000000
00000000000000000000000000000000
00000000000000000000000000000000
00000000000000000000000000000000
00000000000000000111111111000000
00000000000000000000000000000000
00000000000000000000000000000000
00000000000000000001100000111100
11111111111111111000000000000000
00000000000000000000000000000000
00000000000000000000000000000000
00000000000000000000000000000000