00000000000000000000000000000000
00000000000000000000000000000000
00000000000000000000000000000000
00000000000000000000000000001111
00000000000000000000000000000000
00011100000000000000000010000000
00000111000000000000000000000000
00000001110000000000001000000000
00000000011100000000000000000000
00000000100111000000100000000000
00000000100001111100000000000000
00000000100000000000000000000000
00000000100000000100000000001111
00000000100000090100000000000000
00000000100001111100000000000000
00000000100000000000000000001111
00000000110000000000000000000000
00111110100000000000000000000000
00000000100100000000000000000000
00000000100000100011111111100000
00000000000000000000000000000000
00000000000000000000000000000000
00000000000000000000000000000110
00000000000000000000000001100000
01100011000110001100011000000000