00000000000000000000000000000000
00000000000000000000000000000000
00000000000000000000000000000000
00000000000000000000000000000000
00000000000000000000000000000000
00000000000000000000000000000000
00000000000000000000000000000000
00000000000000000000000000000000
00000000000000000000000300050000
06020000000000000000111111111000
11111000000000000000000000000000
00000000000000000000000000000000
00000000000000000020000000000000
00000000111000000111000000000000
00000000000000000000000403040000
00000000000000040000011111111100
00000000000000111000000000000000
00000000000000000000000000000000
00000000000000000000000000000000
00000000000030000000000000000000
00000000000111000000000000000000
00000000000000002030400000000020
11111111111000111111111111000111
00000000000000000000000000000000
00000000000000000000000000000000
00000000000000000000000000000000