00000000000000000000000000000000
00000000000000000000000000000000
00000000000000000000000000000000
00000000000000000000000000000000
00000000000000000000000000000000
00000000000000000000000000000000
00000000000000000000000000000000
00000000000000000000000000000000
00000000000000000000000090000000
00000000000000000000111111000000
00000000000000000000000000000000
00000000000000000000000000000000
00111111111111111000000000000000
00000000000000000000000000000000
00000000000000000000000000000000
00000000000000000111111111000000
00000000000000000000000000000000
00000000000000000000000000000000
00000000000000000000000000000011
00000000000000000000000000000000
00000000000000000000000011110000
00000000000000000001100000000000
11111000111111111000000000000000
00000000000000000000000000000000
00000000000000000000000000000000